START -> S
S -> S NEWLINE S | S NEWLINE | NEWLINE S | S S | FUNC | NONFUNC | VALIDCONST | VALIDLET

NONFUNC -> NONFUNC NONFUNC | NONFUNC NEWLINE NONFUNC | NONFUNC NEWLINE | NEWLINE NONFUNC | EXPR NEWLINE | SWITCHCASE | CONDITIONAL | TRYCATCHFIN | VALIDLET NONFUNC | VALIDCONST NONFUNC | VALIDVAR | WHILELOOP | FORLOOP | DOWHILELOOP | VALIDCONST NONFUNC | VALIDLET NONFUNC | VALIDVAR | VALIDDELETE | ASSIGNMENT | OTHERASSIGNMENT

INFUNC -> NONFUNC | INFUNC INFUNC | INFUNC NEWLINE INFUNC | INFUNC NEWLINE | NEWLINE INFUNC | SWITCHCASEINFUNC | CONDITIONALINFUNC | TRYCATCHFININFUNC | VALIDTHROW | VALIDRET | FORLOOPINFUNC | WHILELOOPINFUNC | DOWHILELOOPINFUNC

INLOOP -> NONFUNC | INLOOP INLOOP | INLOOP NEWLINE INLOOP | INLOOP NEWLINE | NEWLINE INLOOP | CONDITIONALINLOOP | CONTROLFLOW

INLOOPANDFUNC -> INLOOPANDFUNC NEWLINE INLOOPANDFUNC | INLOOPANDFUNC NEWLINE | NEWLINE INLOOPANDFUNC | INLOOP | INFUNC

FUNC -> FUNC FUNC | FUNC NEWLINE FUNC | FUNC NEWLINE | NEWLINE FUNC

FUNCTION -> function
SWITCH -> switch
CURLYOPEN -> _curlyOpen_
CURLYCLOSE -> _curlyClose_
COMMONOPEN -> _commonOpen_
COMMONCLOSE -> _commonClose_
SQUAREOPEN -> _squareOpen_
SQUARECLOSE -> _squareClose_
CASE -> case
DEFAULT -> default
COLON -> _colon_
SEMICOLON -> _semicolon_
ASSIGN -> _assign_
EQUALSIGN -> _equalSign_
COMMA -> _comma_
IF -> if
ELSE -> else
EXPR -> _expression_ | ASSIGNMENT | VARIABLE | VALUE | PARAMLIST
BOOLEAN -> true | false
VARIABLE -> _variable_
VALUE -> NUMBER | STRING | BOOLEAN | NULL
NUMBER -> _number_
NULL -> null
FUNCNAME -> VARIABLE
STRING -> _string_
CONTROLFLOW -> break | continue
RETURN -> return
THROW -> throw
TRY -> try
CATCH -> catch
FINALLY -> finally
CONST -> const
VAR -> var
LET -> let
FOR -> for
WHILE -> while
NEWLINE -> _newline_ | NEWLINE NEWLINE
DELETE -> delete

VALIDTHROW -> THROW EXPR | THROW VARIABLE | THROW OBJECTDEF | THROW STRING | THROW FUNC NEWLINE
VALIDRET -> RETURN | RETURN VARIABLE | RETURN EXPR | RETURN OBJECTDEF | RETURN STRING | RETURN FUNC NEWLINE

INOBJECT -> VARIABLE COLON VALUE | VARIABLE COLON VARIABLE | VARIABLE COLON INOBJECT | INOBJECT COMMA INOBJECT
OBJECTDEF -> VALIDCURLYOPEN INOBJECT VALIDCURLYCLOSE

ASSIGNMENT -> VARIABLE EQUALSIGN EXPR | VARIABLE EQUALSIGN OBJECTDEF NEWLINE | VARIABLE EQUALSIGN ASSIGNMENT

VALIDLET -> LET VARIABLE NEWLINE | LET ASSIGNMENT | VALIDLET VALIDLET
VALIDCONST -> CONST ASSIGNMENT | VALIDCONST VALIDCONST
VALIDVAR -> VAR VARIABLE NEWLINE | VAR ASSIGNMENT

OTHERASSIGNMENT -> VARIABLE ASSIGN EXPR NEWLINE | VARIABLE ASSIGN OBJECTDEF NEWLINE | VARIABLE ASSIGN ASSIGNMENT

VALIDDELETE -> DELETE VARIABLE SQUAREOPEN VARIABLE SQUARECLOSE NEWLINE

CONDITION -> COMMONOPEN EXPR COMMONCLOSE

VALIDCURLYOPEN -> CURLYOPEN | NEWLINE CURLYOPEN | NEWLINE CURLYOPEN NEWLINE | CURLYOPEN NEWLINE
VALIDCURLYCLOSE -> CURLYCLOSE | NEWLINE CURLYCLOSE | NEWLINE CURLYCLOSE NEWLINE | CURLYCLOSE NEWLINE

SWITCHCASE -> SWITCH CONDITION VALIDCURLYOPEN VALIDCASE VALIDCURLYCLOSE | SWITCH CONDITION VALIDCURLYOPEN VALIDCASE VALIDDEF VALIDCURLYCLOSE
SWITCHCASEINFUNC -> SWITCH CONDITION VALIDCURLYOPEN VALIDCASEINFUNC VALIDCURLYCLOSE | SWITCH CONDITION VALIDCURLYOPEN VALIDCASEINFUNC VALIDDEFINFUNC VALIDCURLYCLOSE
VALIDCASE -> VALIDCASE VALIDCASE | CASE VALUE COLON | CASE VALUE COLON NEWLINE | CASE VALUE COLON NONFUNC | CASE VALUE COLON NONFUNC NEWLINE | CASE VALUE COLON NONFUNC NEWLINE CONTROLFLOW NEWLINE
VALIDDEF -> DEFAULT COLON NEWLINE | DEFAULT COLON NONFUNC | DEFAULT COLON NONFUNC NEWLINE | DEFAULT COLON NONFUNC NEWLINE CONTROLFLOW NEWLINE
VALIDCASEINFUNC -> VALIDCASEINFUNC VALIDCASEINFUNC | VALIDCASE | CASE VALUE COLON INFUNC NEWLINE | CASE VALUE COLON INFUNC
VALIDDEFINFUNC -> VALIDDEF | DEFAULT COLON INFUNC NEWLINE | DEFAULT COLON INFUNC

VALIDIF -> IF CONDITION VALIDCURLYOPEN NONFUNC VALIDCURLYCLOSE | IF CONDITION NONFUNC NEWLINE
VALIDIFINLOOP -> VALIDIF | IF CONDITION VALIDCURLYOPEN INLOOP VALIDCURLYCLOSE | IF CONDITION INLOOP NEWLINE
VALIDIFINFUNC -> VALIDIF | IF CONDITION VALIDCURLYOPEN INFUNC VALIDCURLYCLOSE | IF CONDITION INFUNC NEWLINE
VALIDELSE -> ELSE VALIDCURLYOPEN NONFUNC VALIDCURLYCLOSE | ELSE NONFUNC NEWLINE
VALIDELSEINLOOP -> VALIDELSE | ELSE VALIDCURLYOPEN INLOOP VALIDCURLYCLOSE | ELSE INLOOP NEWLINE
VALIDELSEINFUNC -> VALIDELSE | ELSE VALIDCURLYOPEN INFUNC VALIDCURLYCLOSE | ELSE INFUNC NEWLINE
VALIDELSEIF -> ELSE IF CONDITION VALIDCURLYOPEN NONFUNC VALIDCURLYCLOSE | ELSE IF CONDITION NONFUNC NEWLINE | VALIDELSEIF VALIDELSEIF
VALIDELSEIFINLOOP -> VALIDELSEIF | ELSE IF CONDITION VALIDCURLYOPEN INLOOP VALIDCURLYCLOSE | ELSE IF CONDITION INLOOP NEWLINE | VALIDELSEIFINLOOP VALIDELSEIFINLOOP
VALIDELSEIFINFUNC -> VALIDELSEIF | ELSE IF CONDITION VALIDCURLYOPEN INFUNC VALIDCURLYCLOSE | ELSE IF CONDITION INFUNC NEWLINE | VALIDELSEIFINFUNC VALIDELSEIFINFUNC
CONDITIONAL -> VALIDIF | VALIDIF VALIDELSE | VALIDIF VALIDELSEIF VALIDELSE
CONDITIONALINLOOP -> VALIDIFINLOOP | VALIDIFINLOOP VALIDELSEINLOOP | VALIDIFINLOOP VALIDELSEIFINLOOP VALIDELSEINLOOP 
CONDITIONALINFUNC -> VALIDIFINFUNC | VALIDIFINFUNC VALIDELSEINFUNC | VALIDIFINFUNC VALIDELSEIFINFUNC VALIDELSEINFUNC

VALIDTRY -> TRY VALIDCURLYOPEN NONFUNC VALIDCURLYCLOSE
VALIDCATCH -> CATCH VALIDCURLYOPEN NONFUNC VALIDCURLYCLOSE | CATCH COMMONOPEN VARIABLE COMMONCLOSE VALIDCURLYOPEN NONFUNC VALIDCURLYCLOSE
VALIDFIN -> FINALLY VALIDCURLYOPEN NONFUNC VALIDCURLYCLOSE
VALIDTRYINFUNC -> VALIDTRY | TRY VALIDCURLYOPEN INFUNC VALIDCURLYCLOSE
VALIDCATCHINFUNC -> VALIDCATCH | CATCH VALIDCURLYOPEN INFUNC VALIDCURLYCLOSE | CATCH COMMONOPEN VARIABLE COMMONCLOSE VALIDCURLYOPEN INFUNC VALIDCURLYCLOSE
VALIDFININFUNC -> VALIDFIN | FINALLY VALIDCURLYOPEN INFUNC VALIDCURLYCLOSE
TRYCATCHFIN -> VALIDTRY VALIDCATCH | VALIDTRY VALIDFIN | VALIDTRY VALIDCATCH VALIDFIN
TRYCATCHFININFUNC -> VALIDTRYINFUNC VALIDCATCHINFUNC | VALIDTRYINFUNC VALIDFININFUNC | VALIDTRYINFUNC VALIDCATCHINFUNC VALIDFININFUNC

FUNC -> FUNCTION FUNCNAME COMMONOPEN COMMONCLOSE VALIDCURLYOPEN INFUNC VALIDCURLYCLOSE | FUNCTION FUNCNAME COMMONOPEN COMMONCLOSE VALIDCURLYOPEN INFUNC NEWLINE VALIDRET VALIDCURLYCLOSE | FUNCTION FUNCNAME COMMONOPEN PARAMLIST COMMONCLOSE VALIDCURLYOPEN INFUNC VALIDCURLYCLOSE | FUNCTION FUNCNAME COMMONOPEN PARAMLIST COMMONCLOSE VALIDCURLYOPEN INFUNC NEWLINE VALIDRET VALIDCURLYCLOSE | FUNCTION FUNCNAME COMMONOPEN COMMONCLOSE VALIDCURLYOPEN FUNC VALIDCURLYCLOSE | FUNCTION FUNCNAME COMMONOPEN COMMONCLOSE VALIDCURLYOPEN FUNC NEWLINE VALIDRET VALIDCURLYCLOSE | FUNCTION FUNCNAME COMMONOPEN PARAMLIST COMMONCLOSE VALIDCURLYOPEN FUNC VALIDCURLYCLOSE | FUNCTION FUNCNAME COMMONOPEN PARAMLIST COMMONCLOSE VALIDCURLYOPEN FUNC NEWLINE VALIDRET VALIDCURLYCLOSE

PARAM -> VARIABLE | VARIABLE EQUALSIGN VALUE
PARAMLIST -> PARAM | PARAM COMMA PARAM | PARAM COMMA PARAMLIST COMMA PARAM

FORLOOP -> FOR COMMONOPEN EXPR SEMICOLON EXPR SEMICOLON EXPR COMMONCLOSE VALIDCURLYOPEN INLOOP VALIDCURLYCLOSE | FOR COMMONOPEN EXPR SEMICOLON EXPR SEMICOLON EXPR COMMONCLOSE INLOOP NEWLINE
FORLOOPINFUNC -> FORLOOP | FOR COMMONOPEN EXPR SEMICOLON EXPR SEMICOLON EXPR COMMONCLOSE VALIDCURLYOPEN INLOOPANDFUNC VALIDCURLYCLOSE | FOR COMMONOPEN EXPR SEMICOLON EXPR SEMICOLON EXPR COMMONCLOSE INLOOPANDFUNC NEWLINE
WHILELOOP -> WHILE CONDITION INLOOP NEWLINE | WHILE CONDITION VALIDCURLYOPEN INLOOP VALIDCURLYCLOSE
WHILELOOPINFUNC -> WHILELOOP | WHILE CONDITION INLOOPANDFUNC NEWLINE | WHILE CONDITION VALIDCURLYOPEN INLOOPANDFUNC VALIDCURLYCLOSE
DOWHILELOOP -> DO INLOOP NEWLINE WHILE CONDITION NEWLINE | DO VALIDCURLYOPEN INLOOP VALIDCURLYCLOSE WHILE CONDITION
DOWHILELOOPINFUNC -> DOWHILELOOP | DO INLOOPANDFUNC NEWLINE WHILE CONDITION NEWLINE | DO VALIDCURLYOPEN INLOOPANDFUNC VALIDCURLYCLOSE WHILE CONDITION
